11111111111111111111111111111111
1     131    1                 1
1     1    1 1                 1
1     1    1 1                 1
14    2     s1                 1
1     1   1111                 1
1     11    31                 1
1     11111111                 1
1                              1
1                              1
1                              1
1                              1
1                              1
1                              1
1                              1
1                              1
1                              1
1                              1
1                              1
1                              1
1                              1
1                              1
1                              1
1                              1
1                              1
1                              1
1                              1
1                              1
1                              1
1                              1
1                              1
11111111111111111111111111111111
