11111111111111111111111111111111
1                              1
1                              1
1                              1
1   111111111111111111111      1
1   1         1         1      1
1   1 111 111 1 111 111 1      1
1   1 111 111 1 111 111 1      1
1   1                   1      1
1   1 111 1 11111 1 111 1      1
1   1     1   1   1     1      1
1   11111 111 1 111 11111      1
1       1 1       1 1          1
133311111 1 11211 1 111113333331
1   2       14  1       2      1
133311111 1 11111 1 111113333331
1       1 1       1 1          1
1   11111 1 11111 1 11111      1
1   1         1         1      1
1   1 111 111 1 111 111 1      1
1   1   1     s     1   1      1
1   111 1 1 11111 1 1 111      1
1   1     1   1   1     1      1
1   1 1111111 1 1111111 1      1
1   1                   1      1
1   111111111111111111111      1
1                              1
1                              1
1                              1
1                              1
1                              1
11111111111111111111111111111111
